# Mapping between hardware and software for CSC chambers in slice test
# Tim Cox 02-May-2006 after additions from Frank Geurts.
# -1 means no (or missing) information
# =========================================================================
#   endcap  station ring  chamber   vme    dmb     tmb    sector   cscid
# =========================================================================
#ME+1/1
      1       1       1      27       3      1       -1      10       1
      1       1       1      28       3      2       -1      10       2
      1       1       1      29       3      3       -1      10       3
      1       1       1      30       2      1       -1      11       1
      1       1       1      31       2      2       -1      11       2
      1       1       1      32       2      3       -1      11       3
#ME+1/2
      1       1       2      27       3      4       -1      10       4
      1       1       2      28       3      5       -1      10       5
      1       1       2      29       3      7       -1      10       6
      1       1       2      30       2      4       -1      11       4
      1       1       2      31       2      5       -1      11       5
      1       1       2      32       2      7       -1      11       6
#ME+1/3
      1       1       3      27       3      8       -1      10       7
      1       1       3      28       3      9       -1      10       8
      1       1       3      29       3     10       -1      10       9
      1       1       3      30       2      8       -1      11       7
      1       1       3      31       2      9       -1      11       8
      1       1       3      32       2     10       -1      11       9
# ME+2/1
      1       2       1      14       1       1      -1       5       1
      1       2       1      15       1       2      -1       5       2
      1       2       1      16       1       3      -1       5       3
# ME+2/2
      1       2       2      27       1       4      -1       5       4
      1       2       2      28       1       5      -1       5       5
      1       2       2      29       1       7      -1       5       6
      1       2       2      30       1       8      -1       5       7
      1       2       2      31       1       9      -1       5       8
      1       2       2      32       1      10      -1       5       9
# ME+3/1
      1       3       1      14       0       1      -1       5       1
      1       3       1      15       0       2      -1       5       2
      1       3       1      16       0       3      -1       5       3
# ME+3/2
      1       3       2      27       0       4      -1       5       4
      1       3       2      28       0       5      -1       5       5
      1       3       2      29       0       7      -1       5       6
      1       3       2      30       0       8      -1       5       7
      1       3       2      31       0       9      -1       5       8
      1       3       2      32       0      10      -1       5       9
# =========================================================================
#ME-2/1
      2       2       1      8        45       1      -1       5       1
      2       2       1      9        45       2      -1       5       2
      2       2       1      10       45       3      -1       5       3
#ME-2/2
      2       2       2      15       45       4      -1       5       4
      2       2       2      16       45       5      -1       5       5
      2       2       2      17       45       7      -1       5       6
      2       2       2      18       45       8      -1       5       7
      2       2       2      19       45       9      -1       5       8
      2       2       2      20       45      10      -1       5       9
#ME-3/1
      2       3       1      8        51       1      -1       5       1
      2       3       1      9        51       2      -1       5       2
      2       3       1      10       51       3      -1       5       3
#ME-3/2
      2       3       2      15       51       4      -1       5       4
      2       3       2      16       51       5      -1       5       5
      2       3       2      17       51       7      -1       5       6
      2       3       2      18       51       8      -1       5       7
      2       3       2      19       51       9      -1       5       8
      2       3       2      20       51      10      -1       5       9
